
{
	"height" : 15,
	"rows" : 
	[
		[ 1, 1, 1, 1, 1, 1, 1, 1, 1, 1, 1, 1 ],
		[ 1, 0, 0, 0, 0, 0, 0, 0, 0, 0, 0, 0 ],
		[ 1, 0, 0, 0, 0, 0, 0, 0, 0, 0, 0, 0 ],
		[ 1, 0, 0, 0, 0, 0, 0, 0, 0, 0, 0, 0 ],
		[ 1, 0, 0, 0, 0, 0, 0, 0, 0, 0, 0, 0 ],
		[ 1, 0, 0, 0, 0, 0, 0, 0, 0, 0, 0, 0 ],
		[ 1, 0, 0, 0, 0, 0, 0, 0, 0, 0, 0, 0 ],
		[ 1, 0, 0, 0, 0, 0, 0, 0, 0, 0, 0, 0 ],
		[ 1, 0, 0, 0, 0, 0, 0, 0, 0, 0, 0, 0 ],
		[ 1, 0, 0, 0, 0, 0, 0, 0, 0, 0, 0, 0 ],
		[ 1, 0, 0, 0, 0, 0, 0, 0, 0, 0, 0, 0 ],
		[ 1, 0, 0, 0, 0, 0, 0, 0, 0, 0, 0, 0 ],
		[ 1, 0, 0, 0, 0, 0, 0, 0, 0, 0, 0, 0 ],
		[ 1, 0, 0, 0, 0, 0, 0, 0, 0, 0, 0, 0 ],
		[ 1, 0, 0, 0, 0, 0, 0, 0, 0, 0, 0, 0 ]
	],
	"width" : 12
}
